~~~~~~~~~~~~~~~~~~~~~~~~~~~~~~~~~~~~~~~~~~~~~~~~~~~~~~~~~~~
~~~~~~~~~~~~~~~~~~~~~~~~~~~~~~~~~~~~~~~~~~~~~~~~~~~~~~~~~~~
~~~~~~~~~~~~~~~~~~~~~~~~~~~~~~~~~~~~~~~~~~~~~~~~~~~~~~~~~~~
~~~~~~~~~~~~~~~~~~~~~~~~~~~~~~~~~~~~~~~~~~~~~~~~~~~~~~~~~~~
~~~~~~~~~~~~~~~~~~~~~~~~~~~~~~~~~~~~~~~~~~~~~~~~~~~~~~~~~~~
~~~~~######################################################
~~~~~~################################~~~~~~~~~~~~~~~~~~~~~
~~~~~~~~#..........#..............#~~#~~~~~~~~~~~~~~~~~~~~~
~~~~~~~~#......###.#.###.....##...#~~#~~~~~~~~~~~~~~~~~~~~~
~~~~~~~~#..#######.#...#####.##..#####~~~~~~~~~~~~~~~~~~~~~
~~~~~~~~#......@##.#...#..#..##..##~~#~~~~~~~~~~~~~~~~~~~~~
~~~~~~~~#.####..##.#...#.....##....###~~~~~~~~~~~~~~~~~~~~~
~~~~~~~~#..###..#......#..#..##.#....#~~~~~~~~~~~~~~~~~~~~~
~~~~~~~~#.2.....#..#...#..#..##...#..#~~~~~~~~~~~~~~~~~~~~~
~~~~~~~~#..######......#.....##.....##~~~~~~~~~~~~~~~~~~~~~
~~~~~~~~#..###.....#.##########.#....#~~~~~~~~~~~~~~~~~~~~~
~~~~~~~~######..####.###............##~~~~~~~~~~~~~~~~~~~~~
~~~~~~~~####..####..#####.###..####################~~~~~~~~
~~~~~~~~#......###..###....#####.................$#~~~~~~~~
~~~~~~~~#....#.###..###.....#........##############~~~~~~~~
~~~~~~~~#.#....###......#...#..#######~~~~~~~~~~~~~~~~~~~~~
~~~~~~~~#....#####.###...#..#.......##~~~~~~~~~~~~~~~~~~~~~
~~~~~~~~#...##.###.####.....#..#.....#~~~~~~~~~~~~~~~~~~~~~
~~~~~~~~#......###.####.#.#.#######..#~~~~~~~~~~~~~~~~~~~~~
~~~~~~~~#.#.................#........#~~~~~~~~~~~~~~~~~~~~~
~~~~~~~~#####.####..#########....#####~~~~~~~~~~~~~~~~~~~~~
~~~~~~~~#.....##.....##..........#####~~~~~~~~~~~~~~~~~~~~~
~~~~~~~~#..#..##.....##.....##########~~~~~~~~~~~~~~~~~~~~~
~~~~~~~~#.........#..##..####~~~~~#..#~~~~~~~~~~~~~~~~~~~~~
~~~~~~~~#...#..#.....##.....#######..#~~~~~~~~~~~~~~~~~~~~~
~~~~~~~~#............#####...........#~~~~~~~~~~~~~~~~~~~~~
~~~~~~~~#.#...#......##..####..#######~~~~~~~~~~~~~~~~~~~~~
~~~~~~~~#....##..#.............##~~~~#~~~~~~~~~~~~~~~~~~~~~
~~~~~~~~##################..#..##~~~~#~~~~~~~~~~~~~~~~~~~~~
~~~~~~~~#~~~~~~~~~~~~~~~##.....##~~~~#~~~~~~~~~~~~~~~~~~~~~
~~~~~~~~##############################~~~~~~~~~~~~~~~~~~~~~
~~~~~~~~~~~~~~~~~~~~~~~~~~~~~~~~~~~~~~~~~~~~~~~~~~~~~~~~~~~
~~~~~~~~~~~~~~~~~~~~~~~~~~~~~~~~~~~~~~~~~~~~~~~~~~~~~~~~~~~
~~~~~~~~~~~~~~~~~~~~~~~~~~~~~~~~~~~~~~~~~~~~~~~~~~~~~~~~~~~
~~~~~~~~~~~~~~~~~~~~~~~~~~~~~~~~~~~~~~~~~~~~~~~~~~~~~~~~~~~
~~~~~~~~~~~~~~~~~~~~~~~~~~~~~~~~~~~~~~~~~~~~~~~~~~~~~~~~~~~
~~~~~~~~~~~~~~~~~~~~~~~~~~~~~~~~~~~~~~~~~~~~~~~~~~~~~~~~~~~
~~~~~~~~~~~~~~~~~~~~~~~~~~~~~~~~~~~~~~~~~~~~~~~~~~~~~~~~~~~
~~~~~~~~~~~~~~~~~~~~~~~~~~~~~~~~~~~~~~~~~~~~~~~~~~~~~~~~~~~
~~~~~~~~~~~~~~~~~~~~~~~~~~~~~~~~~~~~~~~~~~~~~~~~~~~~~~~~~~~
~~~~~~~~~~~~~~~~~~~~~~~~~~~~~~~~~~~~~~~~~~~~~~~~~~~~~~~~~~~
~~~~~~~~~~~~~~~~~~~~~~~~~~~~~~~~~~~~~~~~~~~~~~~~~~~~~~~~~~~
~~~~~~~~~~~~~~~~~~~~~~~~~~~~~~~~~~~~~~~~~~~~~~~~~~~~~~~~~~~
~~~~~~~~~~~~~~~~~~~~~~~~~~~~~~~~~~~~~~~~~~~~~~~~~~~~~~~~~~~
~~~~~~~~~~~~~~~~~~~~~~~~~~~~~~~~~~~~~~~~~~~~~~~~~~~~~~~~~~~
~~~~~~~~~~~~~~~~~~~~~~~~~~~~~~~~~~~~~~~~~~~~~~~~~~~~~~~~~~~
~~~~~~~~~~~~~~~~~~~~~~~~~~~~~~~~~~~~~~~~~~~~~~~~~~~~~~~~~~~
~~~~~~~~~~~~~~~~~~~~~~~~~~~~~~~~~~~~~~~~~~~~~~~~~~~~~~~~~~~
~~~~~~~~~~~~~~~~~~~~~~~~~~~~~~~~~~~~~~~~~~~~~~~~~~~~~~~~~~~
~~~~~~~~~~~~~~~~~~~~~~~~~~~~~~~~~~~~~~~~~~~~~~~~~~~~~~~~~~~
~~~~~~~~~~~~~~~~~~~~~~~~~~~~~~~~~~~~~~~~~~~~~~~~~~~~~~~~~~~
~~~~~~~~~~~~~~~~~~~~~~~~~~~~~~~~~~~~~~~~~~~~~~~~~~~~~~~~~~~
~~~~~~~~~~~~~~~~~~~~~~~~~~~~~~~~~~~~~~~~~~~~~~~~~~~~~~~~~~~
~~~~~~~~~~~~~~~~~~~~~~~~~~~~~~~~~~~~~~~~~~~~~~~~~~~~~~~~~~~