~~~~~~~~~~~~~~~~~~~~~~~~~~~~~~~~~~~~~~~~~~~~~~~~~~~~~~~~~~~~~~~~~~~~~
~~~~~~~~~~~~~~~~~~~~~~~~~~~~~~~~~~~~~~~~~~~~~~~~~~~~~~~~~~~~~~~~~~~~~
~~~~~~~~~~~~~~~~~~~~~~~~~~~~~~~~~~~~~~~~~~~~~~~~~~~~~~~~~~~~~~~~~~~~~
~~~~~~~~~~~~~~~~~~~~~~~~~~~~~~~~~~~~~~~~~~~~~~~~~~~~~~~~~~~~~~~~~~~~~
~~~~~~~~~~~~~~~~~~~~~~~~~~~~~~~~~~~~~~~~~~~~~~~~~~~~~~~~~~~~~~~~~~~~~
~~~~~~~~~~~~~~~~~~~~~~~~~~~~~~~~~~~~~~~~~~~~~~~~~~~~~~~~~~~~~~~~~~~~~
~~~~~~~~~~~~~~~~~~~~~~~~~~~~~~~~~~~~~~~~~~~~~~~~~~~~~~~~~~~~~~~~~~~~~
~~~~~~~~~~~~~~~~~~~~~~~~~~~~~~~~~~~~~~~~~~~~~~~~~~~~~~~~~~~~~~~~~~~~~
~~~~~~~#######~~~~~~~~~~~~~~~~~~~#############~~~~~~~~~~~~~~~~~~~~~~~
~~~~~~~#####~~~~~~~~~~~~~~~~~~~~~#.......#################~~~~~~~~~~~
~~~~~~~######~~~~~~~~~~~~~~~~~~~~#..#.#..................#~~~~~~~~~~~
~~~~~~~###~#~~~~~~~~~~~~~~~~~~~~~#...##......####.########~~~~~~~~~~~
~~~~~~~##~~~~~~~~~~~~~~~~~~~~~~~~#....#.....#.........#~~~~~~~~~~~~~~
~~~~~~~~~~~##~~~~~~~~~~~~~~~~~~~~#...#####..#.........#~~~~~~~~~~~~~~
~~~~~~~###########################....#.....#.........#~~~~~~~~~~~~~~
~~~~~~~###...2......@...........#.....#..##############~~~~~~~~~~~~~~
~~~~~~~###.##############.#######..#..#..####~~~~~~~~~~~~~~~~~~~~~~~~
~~~~~~~###.##~~~~~~#...............#........#~~~~~~~~~~~~~~~~~~~~~~~~
~~~~~~~###.#########............#############~~~~~~~~~~~~~~~~~~~~~~~~
~~~~~~~###.##......##############~~~~~~~~~~~~~~~~~~~~~~~~~~~~~~~~~~~~
~~~~~~~###.............####~~~~~#~~~~~~~~~~~~~~~~~~~~~~~~~~~~~~~~~~~~
~~~~~~~##############..##########~~~~~~~~~~~~~~~~~~~~~~~~~~~~~~~~~~~~
~~~~~~~###~~~~~~~~###....#~~~~~~~~~~~~~~~~~~~~~~~~~~~~~~~~~~~~~~~~~~~
~~~~~~~############......#~~~~~~~~~~~~~~~~~~~~~~~~~~~~~~~~~~~~~~~~~~~
~~~~~~~##############...##########################~~~~~~~~~~~~~~~~~~~
~~~~~~~###~~~~~####......#.........#~~~~~~~~~~~##~~~~~~~~~~~~~~~~~~~~
~~~~~~~###~~###~~~#......#.....#...#~~~~~~~~~~~#~~~~~~~~~~~~~~~~~~~~~
~~~~~~~############......##....#...#################################~
~~~~~~~########................#....................$...............~
~~~~~~~########..######### #############..##########################~
~~~~~~~####.........#~~~#........##............#~~~~~~~~~~~~~~~~~~~~~
~~~~~~~####......#..#~~~#.....#...#............#~~~~~~~~~~~~~~~~~~~~~
~~~~~~~####..#......#####....###..#....#########~~~~~~~~~~~~~~~~~~~~~
~~~~~~~####......####.............#........#####~~~~~~~~~~~~~~~~~~~~~
~~~~~~~####..#......##...#........######.......#~~~~~~~~~~~~~~~~~~~~~
~~~~~~~######...###############...#.......######~~~~~~~~~~~~~~~~~~~~~
~~~~~~~####~#####~~~#~~##~~~~~#......######~~~~#~~~~~~~~~~~~~~~~~~~~~
~~~~~~~#########################################~~~~~~~~~~~~~~~~~~~~~
#############################################################~~~~~~~~
##############################################################~~~~~~~
~~~~~~~~~~~~~~~~~~~~~~~~~~~~~~~~~~~~~~~~~~~~~~~~~~~~~~~~~~~~~~~~~~~~~
~~~~~~~~~~~~~~~~~~~~~~~~~~~~~~~~~~~~~~~~~~~~~~~~~~~~~~~~~~~~~~~~~~~~~
~~~~~~~~~~~~~~~~~~~~~~~~~~~~~~~~~~~~~~~~~~~~~~~~~~~~~~~~~~~~~~~~~~~~~
~~~~~~~~~~~~~~~~~~~~~~~~~~~~~~~~~~~~~~~~~~~~~~~~~~~~~~~~~~~~~~~~~~~~~
~~~~~~~~~~~~~~~~~~~~~~~~~~~~~~~~~~~~~~~~~~~~~~~~~~~~~~~~~~~~~~~~~~~~~
~~~~~~~~~~~~~~~~~~~~~~~~~~~~~~~~~~~~~~~~~~~~~~~~~~~~~~~~~~~~~~~~~~~~~
~~~~~~~~~~~~~~~~~~~~~~~~~~~~~~~~~~~~~~~~~~~~~~~~~~~~~~~~~~~~~~~~~~~~~
~~~~~~~~~~~~~~~~~~~~~~~~~~~~~~~~~~~~~~~~~~~~~~~~~~~~~~~~~~~~~~~~~~~~~
~~~~~~~~~~~~~~~~~~~~~~~~~~~~~~~~~~~~~~~~~~~~~~~~~~~~~~~~~~~~~~~~~~~~~
~~~~~~~~~~~~~~~~~~~~~~~~~~~~~~~~~~~~~~~~~~~~~~~~~~~~~~~~~~~~~~~~~~~~~
~~~~~~~~~~~~~~~~~~~~~~~~~~~~~~~~~~~~~~~~~~~~~~~~~~~~~~~~~~~~~~~~~~~~~
~~~~~~~~~~~~~~~~~~~~~~~~~~~~~~~~~~~~~~~~~~~~~~~~~~~~~~~~~~~~~~~~~~~~~
~~~~~~~~~~~~~~~~~~~~~~~~~~~~~~~~~~~~~~~~~~~~~~~~~~~~~~~~~~~~~~~~~~~~~
~~~~~~~~~~~~~~~~~~~~~~~~~~~~~~~~~~~~~~~~~~~~~~~~~~~~~~~~~~~~~~~~~~~~~
~~~~~~~~~~~~~~~~~~~~~~~~~~~~~~~~~~~~~~~~~~~~~~~~~~~~~~~~~~~~~~~~~~~~~
~~~~~~~~~~~~~~~~~~~~~~~~~~~~~~~~~~~~~~~~~~~~~~~~~~~~~~~~~~~~~~~~~~~~~
~~~~~~~~~~~~~~~~~~~~~~~~~~~~~~~~~~~~~~~~~~~~~~~~~~~~~~~~~~~~~~~~~~~~~
~~~~~~~~~~~~~~~~~~~~~~~~~~~~~~~~~~~~~~~~~~~~~~~~~~~~~~~~~~~~~~~~~~~~~
~~~~~~~~~~~~~~~~~~~~~~~~~~~~~~~~~~~~~~~~~~~~~~~~~~~~~~~~~~~~~~~~~~~~~
~~~~~~~~~~~~~~~~~~~~~~~~~~~~~~~~~~~~~~~~~~~~~~~~~~~~~~~~~~~~~~~~~~~~~
~~~~~~~~~~~~~~~~~~~~~~~~~~~~~~~~~~~~~~~~~~~~~~~~~~~~~~~~~~~~~~~~~~~~~
~~~~~~~~~~~~~~~~~~~~~~~~~~~~~~~~~~~~~~~~~~~~~~~~~~~~~~~~~~~~~~~~~~~~~
~~~~~~~~~~~~~~~~~~~~~~~~~~~~~~~~~~~~~~~~~~~~~~~~~~~~~~~~~~~~~~~~~~~~~
~~~~~~~~~~~~~~~~~~~~~~~~~~~~~~~~~~~~~~~~~~~~~~~~~~~~~~~~~~~~~~~~~~~~~
~~~~~~~~~~~~~~~~~~~~~~~~~~~~~~~~~~~~~~~~~~~~~~~~~~~~~~~~~~~~~~~~~~~~~
~~~~~~~~~~~~~~~~~~~~~~~~~~~~~~~~~~~~~~~~~~~~~~~~~~~~~~~~~~~~~~~~~~~~~
~~~~~~~~~~~~~~~~~~~~~~~~~~~~~~~~~~~~~~~~~~~~~~~~~~~~~~~~~~~~~~~~~~~~~
~~~~~~~~~~~~~~~~~~~~~~~~~~~~~~~~~~~~~~~~~~~~~~~~~~~~~~~~~~~~~~~~~~~~~
~~~~~~~~~~~~~~~~~~~~~~~~~~~~~~~~~~~~~~~~~~~~~~~~~~~~~~~~~~~~~~~~~~~~~
