~~~~~~~~~~~~~~~~~~~~~~~~~~~~~~~~~~~~~~~~~~~~~~~~~~~~~~~~~~~
~~~~~~~~~~~~~~~~~~~~~~~~~~~~~~~~~~~~~~~~~~~~~~~~~~~~~~~~~~~
~~~~~~~~~~~~~~~~~~~~~~~~~~~~~~~~~~~~~~~~~~~~~~~~~~~~~~~~~~~
~~~~~~~~~~~~~~~~~~~~~~~~~~~~~~~~~~~~~~~~~~~~~~~~~~~~~~~~~~~
~~~~~~~~~~~~~~~~~~~~~~~~~~~~~~~~~~~~~~~~~~~~~~~~~~~~~~~~~~~
~~~~~######################################################
~~~~~~################################~~~~~~~~~~~~~~~~~~~~~
~~~~~~~~#.........................#~~#~~~~~~~~~~~~~~~~~~~~~
~~~~~~~~#......###.#.###.....##...#~~#~~~~~~~~~~~~~~~~~~~~~
~~~~~~~~#..#######.#...#####.##..#####~~~~~~~~~~~~~~~~~~~~~
~~~~~~~~#......@##.#...#..#..##......#~~~~~~~~~~~~~~~~~~~~~
~~~~~~~~#.####..##.#...#.....##......#~~~~~~~~~~~~~~~~~~~~~
~~~~~~~~#..###..#......#..#..##.#....#~~~~~~~~~~~~~~~~~~~~~
~~~~~~~~#.2.....#..#...#..#..##...#..#~~~~~~~~~~~~~~~~~~~~~
~~~~~~~~#..######......#.....##......#~~~~~~~~~~~~~~~~~~~~~
~~~~~~~~#..###.....#.##########.#....#~~~~~~~~~~~~~~~~~~~~~
~~~~~~~~######..####.###....#........#~~~~~~~~~~~~~~~~~~~~~
~~~~~~~~#...................#..#####.#~~~~~~~~~~~~~~~~~~~~~
~~~~~~~~####..####..#####.###..#.....#~~~~~~~~~~~~~~~~~~~~~
~~~~~~~~#......###..###....##..#..#..#~~~~~~~~~~~~~~~~~~~~~
~~~~~~~~#....#.###..###.....#..#.....#~~~~~~~~~~~~~~~~~~~~~
~~~~~~~~#.#....###......#...#..#######~~~~~~~~~~~~~~~~~~~~~
~~~~~~~~#....#####.###...#..#.......##~~~~~~~~~~~~~~~~~~~~~
~~~~~~~~#...##.###.####.....#..#.....#~~~~~~~~~~~~~~~~~~~~~
~~~~~~~~#......###.####.#.#.#######..#~~~~~~~~~~~~~~~~~~~~~
~~~~~~~~#.#.................#........#~~~~~~~~~~~~~~~~~~~~~
~~~~~~~~#####.####..#########....#####~~~~~~~~~~~~~~~~~~~~~
~~~~~~~~#.....##.....##..........#####~~~~~~~~~~~~~~~~~~~~~
~~~~~~~~#..#..##.....##.....###############################
~~~~~~~~#.........#..##..####~~~~~#.............$..........
~~~~~~~~#...#..#.....##.....#######..######################
~~~~~~~~#............#####...........#~~~~~~~~~~~~~~~~~~~~~
~~~~~~~~#.#...#......##..####..#######~~~~~~~~~~~~~~~~~~~~~
~~~~~~~~#....##..#...##.....#..##~~~~#~~~~~~~~~~~~~~~~~~~~~
~~~~~~~~##################..#..##~~~~#~~~~~~~~~~~~~~~~~~~~~
~~~~~~~~#~~~~~~~~~~~~~~~##.....##~~~~#~~~~~~~~~~~~~~~~~~~~~
~~~~~~~~##############################~~~~~~~~~~~~~~~~~~~~~
~~~~~~~~~~~~~~~~~~~~~~~~~~~~~~~~~~~~~~~~~~~~~~~~~~~~~~~~~~~
~~~~~~~~~~~~~~~~~~~~~~~~~~~~~~~~~~~~~~~~~~~~~~~~~~~~~~~~~~~
~~~~~~~~~~~~~~~~~~~~~~~~~~~~~~~~~~~~~~~~~~~~~~~~~~~~~~~~~~~
~~~~~~~~~~~~~~~~~~~~~~~~~~~~~~~~~~~~~~~~~~~~~~~~~~~~~~~~~~~
~~~~~~~~~~~~~~~~~~~~~~~~~~~~~~~~~~~~~~~~~~~~~~~~~~~~~~~~~~~
~~~~~~~~~~~~~~~~~~~~~~~~~~~~~~~~~~~~~~~~~~~~~~~~~~~~~~~~~~~
~~~~~~~~~~~~~~~~~~~~~~~~~~~~~~~~~~~~~~~~~~~~~~~~~~~~~~~~~~~
~~~~~~~~~~~~~~~~~~~~~~~~~~~~~~~~~~~~~~~~~~~~~~~~~~~~~~~~~~~
~~~~~~~~~~~~~~~~~~~~~~~~~~~~~~~~~~~~~~~~~~~~~~~~~~~~~~~~~~~
~~~~~~~~~~~~~~~~~~~~~~~~~~~~~~~~~~~~~~~~~~~~~~~~~~~~~~~~~~~
~~~~~~~~~~~~~~~~~~~~~~~~~~~~~~~~~~~~~~~~~~~~~~~~~~~~~~~~~~~
~~~~~~~~~~~~~~~~~~~~~~~~~~~~~~~~~~~~~~~~~~~~~~~~~~~~~~~~~~~
~~~~~~~~~~~~~~~~~~~~~~~~~~~~~~~~~~~~~~~~~~~~~~~~~~~~~~~~~~~
~~~~~~~~~~~~~~~~~~~~~~~~~~~~~~~~~~~~~~~~~~~~~~~~~~~~~~~~~~~
~~~~~~~~~~~~~~~~~~~~~~~~~~~~~~~~~~~~~~~~~~~~~~~~~~~~~~~~~~~
~~~~~~~~~~~~~~~~~~~~~~~~~~~~~~~~~~~~~~~~~~~~~~~~~~~~~~~~~~~
~~~~~~~~~~~~~~~~~~~~~~~~~~~~~~~~~~~~~~~~~~~~~~~~~~~~~~~~~~~
~~~~~~~~~~~~~~~~~~~~~~~~~~~~~~~~~~~~~~~~~~~~~~~~~~~~~~~~~~~
~~~~~~~~~~~~~~~~~~~~~~~~~~~~~~~~~~~~~~~~~~~~~~~~~~~~~~~~~~~
~~~~~~~~~~~~~~~~~~~~~~~~~~~~~~~~~~~~~~~~~~~~~~~~~~~~~~~~~~~
~~~~~~~~~~~~~~~~~~~~~~~~~~~~~~~~~~~~~~~~~~~~~~~~~~~~~~~~~~~
~~~~~~~~~~~~~~~~~~~~~~~~~~~~~~~~~~~~~~~~~~~~~~~~~~~~~~~~~~~
