~~~~~~~~~~~~~~~~~~~~~~~~~~~~~~~~~~~~~~~~~~~~~~~~~~~~~~~~~~~~~~~~~~~~~~~~~~~~~~~~~~~~~
~~~~~~~~~~~~~~~~~~~~~~~~~~~~~~~~~~~~~~~~~~~~~~~~~~~~~~~~~~~~~~~~~~~~~~~~~~~~~~~~~~~~~
~~~~~~~~~~~~~~~~~~~~~~~~~~~~~~~~~~~~~~~~~~~~~~~~~~~~~~~~~~~~~~~~~~~~~~~~~~~~~~~~~~~~~
~~~~~~~~~~~~~~~~~~~~~~~~~~~~~~~~~~~~~~~~~~~~~~~~~~~~~~~~~~~~~~~~~~~~~~~~~~~~~~~~~~~~~
~~~~~~~~~~~~~~~~~~~~~~~~~~~~~~~~~~~~~~~~~~~~~~~~~~~~~~~~~~~~~~~~~~~~~~~~~~~~~~~~~~~~~
~~~~~~~~~~~~~~~~~~~~~~~~~~~~~~~~~~~~~~~~~~~~~~~~~~~~~~~~~~~~~~~~~~~~~~~~~~~~~~~~~~~~~
~~~~~~~~~~~~~~~~~~~~~~~~~~~~~~~~~~~~~~~~~~~~~~~~~~~~~~~~~~~~~~~~~~~~~~~~~~~~~~~~~~~~~
~~~~~~~~~~~~~~~~~~~~~~~~~~~~~~~~~~~~~~~~~~~~~~~~~~~~~~~~~~~~~~~~~~~~~~~~~~~~~~~~~~~~~
~~~~~~~~~~~~~~~~~~~~~~~~~~~~~~~~~~~~~~~~~~~~~~~~~~~~~~~~~~~~~~~~~~~~~~~~~~~~~~~~~~~~~
~~~~~~~~~~~~~~~~~~~~~~~~~~~~~~~~~~~~~~~~~~~~~~~~~~~~~~~~~~~~~~~~~~~~~~~~~~~~~~~~~~~~~
~~~~~~~~~~~~~~~~~~~~~~~~~~~~~~~~~~~~~~~~~~~~~~~~~~~~~~~~~~~~~~~~~~~~~~~~~~~~~~~~~~~~~
~~~~~~~~~~~~~~~~~~~~~~~~~~~~~~~~~~~~~~~~~~~~~~~~~~~~~~~~~~~~~~~~~~~~~~~~~~~~~~~~~~~~~
~~~~~~~~~~~~~~~~~~~~~~~~~~~~~~~~~~~~~~~~~~~~~~~~~~~~~~~~~~~~~~~~~~~~~~~~~~~~~~~~~~~~~
~~~~~~~~~~~~~~~~~~~~~~~~~~~~~~~~~~~~~~~~~~~~~~~~~~~~~~~~~~~~~~~~~~~~~~~~~~~~~~~~~~~~~
~~~~~~~~~~~~~~~~~~~~~~~~~~~~~~~~~~~~~~~~~~~~~~~~~~~~~~~~~~~~~~~~~~~~~~~~~~~~~~~~~~~~~
~~~~~~~~~~~~~~~~~~~~~~~~~~~~~~~~~~~~~~~~~~~~~~~~~~~~~~~~~~~~~~~~~~~~~~~~~~~~~~~~~~~~~
~~~~~~~~~~~~~~~~~~~~~~~~~~~~~~~~~~~~~~~~~~~~~~~~~~~~~~~~~~~~~~~~~~~~~~~~~~~~~~~~~~~~~
~~~~~~~~~~~~~~~~~~~~~~~~~~~~~~~~~~~~~~~~~~~~~~~~~~~~~~~~~~~~~~~~~~~~~~~~~~~~~~~~~~~~~
~~~~~~~~~~~~~~~~~~~~~~~~~~~~~~~~~~~~~~~~~~~~~~~~~~~~~~~~~~~~~~~~~~~~~~~~~~~~~~~~~~~~~
~~~~~~~~~~~~##########################################################~~~~~~~~~~~~~~~
~~~~~~~~~~~~#.......#.......##....##.............#~~~~#..............###~~~~~~~~~~~~~
~~~~~~~~~~~~#.......#..............#.............#~~~~#..............##~~~~~~~~~~~~~~
~~~~~~~~~~~~##.#########.#################.#############.########.#####~~~~~~~~~~~~~~
~~~~~~~~~~~~#...............#~~~~~~~~~~~~#.................####....#.##~~~~~~~~~~~~~~
~~~~~~~~~~~~#........#......#~~~~~~~~~~~~#......#.............#......##~~~~~~~~~~~~~~
~~~~~~~~~~~~#...#....#......#~~~~~~~~~~~~#......#.....#...#.....#....##~~~~~~~~~~~~~~
~~~~~~~~~~~~#........#......#~~~~#########......#.............#......##~~~~~~~~~~~~~~
~~~~~~~~~~~~##.......#......#~~~~#..............###.....#.....##.#...##~~~~~~~~~~~~~~
~~~~~~~~~~~~####.######..#####################.############.########.##~~~~~~~~~~~~~~
~~~~~~~~~~~~#........................................................##~~~~~~~~~~~~~~
~~~~~~~~~~~~#........................................................##~~~~~~~~~~~~~~
~~~~~~~~~~~~#........................................................##~~~~~~~~~~~~~~
~~~~~~~~~~~~##########################################...##############~~~~~~~~~~~~~~
~~~~~~~~~~~~#~~~~~~~~~~~~~~~~~~~~~~~~~~~~~~~~~~~~~~###...####~~~~~~~~~#~~~~~~~~~~~~~~
~~~~~~~~~~~~##~~~~~~~~~~~~~~~~~~~~~~~~~~~~~~~~~~~~~###...####~~~~~~~~~#~~~~~~~~~~~~~~
~~~~~~~~~~~~############################################.##############~~~~~~~~~~~~~~
~~~~~~~~~~~~#~~~~~~~~~~~~~~~~~~~~#.....................#.............##~~~~~~~~~~~~~~
~~~~~~~~~~~~#~~~~~~~~~~~~~~~~~~~~#.....................###########...##~~~~~~~~~~~~~~
~~~~~~~~~~~~###########################.##########.######~~~~~######.##~~~~~~~~~~~~~~
~~~~~~~~~~~~###########...........#......#~~~~#........#######.......##~~~~~~~~~~~~~~
~~~~~~~~~~~~##..........#.........#......#~~~~#........#.............##~~~~~~~~~~~~~~
~~~~~~~~~~~~##......#...#.........#......#~~~~#...##...#...#.........##~~~~~~~~~~~~~~
~~~~~~~~~~~~##..........#.....#...#......#~~~~#...##...#.......#.....##~~~~~~~~~~~~~~
~~~~~~~~~~~~##..........#................#~~~~#........#...........####~~~~~~~~~~~~~~
~~~~~~~~~~~~##.##########.###########.##########.#######.####.#########~~~~~~~~~~~~~~
~~~~~~~~~~~~#..................................................###~~~##~~~~~~~~~~~~~~
~~~~~~~~~~~~#####....................#.........................#~~~~~##~~~~~~~~~~~~~~
~~~~~~~~~~~~##############################.....................########~~~~~~~~~~~~~~
~~~~~~~~~~~~#####################~~~~~######.############............##~~~~~~~~~~~~~~
~~~~~~~~~~~~#~~~~~~~~~~~~~~~~~~~~~~~~~#.........#~~#.......#.........##~~~~~~~~~~~~~~
~~~~~~~~~~~~#################################################........##~~~~~~~~~~~~~~
~~~~~~~~~~~~################..###~~~~~#########......##########......##~~~~~~~~~~~~~~
~~~~~~~~~~~~###.....########..###~~~~~#..............#~~~~~~~~##.....##~~~~~~~~~~~~~~
~~~~~~~~~~~~###...##########..####~~~######.#######.##############...##~~~~~~~~~~~~~~
~~~~~~~~~~~~#.....###..#.........#~~~##......#.........#............###~~~~~~~~~~~~~~
~~~~~~~~~~~~#########..#.........#~~~~#......#........#.....#.......##~~~~~~~~~~~~~~~
~~~~~~~~~~~~~~~#.......#.........#~~~~#......#.......#......#.......##~~~~~~~~~~~~~~~
~~~~~~~~~~~~#####......#.........######......#......#.......#.......##~~~~~~~~~~~~~~~
~~~~~~~~~~~~~~~~####.######.######.####.#######.#######.######.#######~~~~~~~~~~~~~~~
~~~~~~~~~~~~#####@..................................................##~~~~~~~~~~~~~~~
~~~~~~~~~~~~#####.####################################################~~~~~~~~~~~~~~~
~~~~~~~~~~~~#####.#~~~~~~~~~~~~~~~~~~~~~~~~~~~~~~~~~~~~~~~~~~~~~~~~~##~~~~~~~~~~~~~~~
~~~~~~~~~~~~#####.###~~~~~~~~~~~~~~~~~~~~~~~~~~~~~~~~~~~~~~~~~~~~~~~##~~~~~~~~~~~~~~~
~~~~~~~~~~~~#####.###~~~~~~~~~~~~~~~~~~~~~~~~~~~~~~~~~~~~~~~~~~~~~~~##~~~~~~~~~~~~~~~
~~~~~~~~~~~~#####2###~~~~~~~~~~~~~~~~~~~~~~~~~~~~~~~~~~~~~~~~~~~~~~~##~~~~~~~~~~~~~~~
~~~~~~~~~~~~~~~##.####################################################~~~~~~~~~~~~~~~
~~~~~~~~~~~~#####....$#~~~~~~~~~~~~~~~~~~~~~~~~~~~~~~~~~~~~~~~~~~~~~~~~~~~~~~~~~~~~~~
~~~~~~~~~~~~############################################################~~~~~~~~~~~~~
~~~~~~~~~~~~~~~~~~~~~~~~~~~~~~~~~~~~~~~~~~~~~~~~~~~~~~~~~~~~~~~~~~~~~~~~~~~~~~~~~~~~~
~~~~~~~~~~~~~~~~~~~~~~~~~~~~~~~~~~~~~~~~~~~~~~~~~~~~~~~~~~~~~~~~~~~~~~~~~~~~~~~~~~~~~
~~~~~~~~~~~~~~~~~~~~~~~~~~~~~~~~~~~~~~~~~~~~~~~~~~~~~~~~~~~~~~~~~~~~~~~~~~~~~~~~~~~~~
~~~~~~~~~~~~~~~~~~~~~~~~~~~~~~~~~~~~~~~~~~~~~~~~~~~~~~~~~~~~~~~~~~~~~~~~~~~~~~~~~~~~~
~~~~~~~~~~~~~~~~~~~~~~~~~~~~~~~~~~~~~~~~~~~~~~~~~~~~~~~~~~~~~~~~~~~~~~~~~~~~~~~~~~~~~
~~~~~~~~~~~~~~~~~~~~~~~~~~~~~~~~~~~~~~~~~~~~~~~~~~~~~~~~~~~~~~~~~~~~~~~~~~~~~~~~~~~~~
~~~~~~~~~~~~~~~~~~~~~~~~~~~~~~~~~~~~~~~~~~~~~~~~~~~~~~~~~~~~~~~~~~~~~~~~~~~~~~~~~~~~~
~~~~~~~~~~~~~~~~~~~~~~~~~~~~~~~~~~~~~~~~~~~~~~~~~~~~~~~~~~~~~~~~~~~~~~~~~~~~~~~~~~~~~
~~~~~~~~~~~~~~~~~~~~~~~~~~~~~~~~~~~~~~~~~~~~~~~~~~~~~~~~~~~~~~~~~~~~~~~~~~~~~~~~~~~~~
~~~~~~~~~~~~~~~~~~~~~~~~~~~~~~~~~~~~~~~~~~~~~~~~~~~~~~~~~~~~~~~~~~~~~~~~~~~~~~~~~~~~~
~~~~~~~~~~~~~~~~~~~~~~~~~~~~~~~~~~~~~~~~~~~~~~~~~~~~~~~~~~~~~~~~~~~~~~~~~~~~~~~~~~~~~
~~~~~~~~~~~~~~~~~~~~~~~~~~~~~~~~~~~~~~~~~~~~~~~~~~~~~~~~~~~~~~~~~~~~~~~~~~~~~~~~~~~~~
~~~~~~~~~~~~~~~~~~~~~~~~~~~~~~~~~~~~~~~~~~~~~~~~~~~~~~~~~~~~~~~~~~~~~~~~~~~~~~~~~~~~~
~~~~~~~~~~~~~~~~~~~~~~~~~~~~~~~~~~~~~~~~~~~~~~~~~~~~~~~~~~~~~~~~~~~~~~~~~~~~~~~~~~~~~
~~~~~~~~~~~~~~~~~~~~~~~~~~~~~~~~~~~~~~~~~~~~~~~~~~~~~~~~~~~~~~~~~~~~~~~~~~~~~~~~~~~~~
~~~~~~~~~~~~~~~~~~~~~~~~~~~~~~~~~~~~~~~~~~~~~~~~~~~~~~~~~~~~~~~~~~~~~~~~~~~~~~~~~~~~~
~~~~~~~~~~~~~~~~~~~~~~~~~~~~~~~~~~~~~~~~~~~~~~~~~~~~~~~~~~~~~~~~~~~~~~~~~~~~~~~~~~~~~
