~~~~~~~~~~~~~~~~~~~~~~~~~~~~~~~~~~~~~~~~~~~~~~~~~~~~~~~~~~~~~~~~~~~~~~~~~~~~~~~~~~~~
~~~~~~~~~~~~~~~~~~~~~~~~~~~~~~~~~~~~~~~~~~~~~~~~~~~~~~~~~~~~~~~~~~~~~~~~~~~~~~~~~~~~
~~~~~~~~~~~~~~~~~~~~~~~~~~~~~~~~~~~~~~~~~~~~~~~~~~~~~~~~~~~~~~~~~~~~~~~~~~~~~~~~~~~~
~~~~~~~~~~~~~~~~~~~~~~~~~~~~~~~~~~~~~~~~~~~~~~~~~~~~~~~~~~~~~~~~~~~~~~~~~~~~~~~~~~~~
~~~~~~~~~~~~~~~~~~~~~~~~~~~~~~~~~~~~~~~~~~~~~~~~~~~~~~~~~~~~~~~~~~~~~~~~~~~~~~~~~~~~
~~~~~~~~~~~~~~~~~~~~~~~~~~~~~~~~~~~~~~~~~~~~~~~~~~~~~~~~~~~~~~~~~~~~~~~~~~~~~~~~~~~~
~~~~~~~~~~~~~~~~~~~~~~~~~~~~~~~~~~~~~~~~~~~~~~~~~~~~~~~~~~~~~~~~~~~~~~~~~~~~~~~~~~~~
~~~~~~~~~~~~~~~~~~~~~~~~~~~~~~~~~~~~~~~~~~~~~~~~~~~~~~~~~~~~~~~~~~~~~~~~~~~~~~~~~~~~
~~~~~~~~~~~~~~~~~~~~~~~~~~~~~~~~~~~~~~~~~~~~~~~~~~~~~~~~~~~~~~~~~~~~~~~~~~~~~~~~~~~~
~~~~~~~~~~~~~~~~~~~~~~~~~~~~~~~~~~~~~~~~~~~~~~~~~~~~~~~~~~~~~~~~~~~~~~~~~~~~~~~~~~~~
~~~~~~~~~~~~~~~~~~~~~~~~~~~~~~~~~~~~~~~~~~~~~~~~~~~~~~~~~~~~~~~~~~~~~~~~~~~~~~~~~~~~
~~~~~~~~~~~~~~~~~~~~~~~~~~~~~~~~~~~~~~~~~~~~~~~~~~~~~~~~~~~~~~~~~~~~~~~~~~~~~~~~~~~~
~~~~~~~~~~~~~~~~~~~~~~~~~~~~~~~~~~~~~~~~~~~~~~~~~~~~~~~~~~~~~~~~~~~~~~~~~~~~~~~~~~~~
~~~~~~~~~~~~~~~~~~~~~~~~~~~~~~~~~~~~~~~~~~~~~~~~~~~~~~~~~~~~~~~~~~~~~~~~~~~~~~~~~~~~
~~~~~~~~~~~~~~~~~~~~~~~~~~~~~~~~~~~~~~~~~~~~~~~~~~~~~~~~~~~~~~~~~~~~~~~~~~~~~~~~~~~~
~~~~~~~~~~~~~~~~~~~~~~~~~~~~~~~~~~~~~~~~~~~~~~~~~~~~~~~~~~~~~~~~~~~~~~~~~~~~~~~~~~~~
~~~~~~~~~~~~~~~~~~~~~~~~~~~~~~~~~~~~~~~~~~~~~~~~~~~~~~~~~~~~~~~~~~~~~~~~~~~~~~~~~~~~
~~~~~~~~~~~~~~~~~~~~~~~~~~~~~~~~~~~~~~~~~~~~~~~~~~~~~~~~~~~~~~~~~~~~~~~~~~~~~~~~~~~~
~~~~~~~~~~~~~~~~~~~~~~~~~~~~~~~~~~~~~~~~~~~~~~~~~~~~~~~~~~~~~~~~~~~~~~~~~~~~~~~~~~~~
~~~~~~~~~~~~##########################################################~~~~~~~~~~~~~~
~~~~~~~~~~~~#.......#.......##....##.............#~~~~#..............###~~~~~~~~~~~~
~~~~~~~~~~~~#.......#..............#.............#~~~~#..............##~~~~~~~~~~~~~
~~~~~~~~~~~~##.#########.#################.#############.########.#####~~~~~~~~~~~~~
~~~~~~~~~~~~#...............#~~~~~~~~~~~~#.................####....#.##~~~~~~~~~~~~~
~~~~~~~~~~~~#........#......#~~~~~~~~~~~~#......#.............#......##~~~~~~~~~~~~~
~~~~~~~~~~~~#...#....#......#~~~~~~~~~~~~#......#.....#...#.....#....##~~~~~~~~~~~~~
~~~~~~~~~~~~#........#......#~~~~#########......#.............#......##~~~~~~~~~~~~~
~~~~~~~~~~~~##.......#......#~~~~#..............###.....#.....##.#...##~~~~~~~~~~~~~
~~~~~~~~~~~~####.######..#####################.############.########.##~~~~~~~~~~~~~
~~~~~~~~~~~~#........................................................##~~~~~~~~~~~~~
~~~~~~~~~~~~#........................................................##~~~~~~~~~~~~~
~~~~~~~~~~~~#........................................................##~~~~~~~~~~~~~
~~~~~~~~~~~~##########################################...##############~~~~~~~~~~~~~
~~~~~~~~~~~~#~~~~~~~~~~~~~~~~~~~~~~~~~~~~~~~~~~~~~~###...####~~~~~~~~~#~~~~~~~~~~~~~
~~~~~~~~~~~~##~~~~~~~~~~~~~~~~~~~~~~~~~~~~~~~~~~~~~###...####~~~~~~~~~#~~~~~~~~~~~~~
~~~~~~~~~~~~############################################.##############~~~~~~~~~~~~~
~~~~~~~~~~~~#~~~~~~~~~~~~~~~~~~~~#.....................#.............##~~~~~~~~~~~~~
~~~~~~~~~~~~#~~~~~~~~~~~~~~~~~~~~#.....................###########...##~~~~~~~~~~~~~
~~~~~~~~~~~~########################### ########## ######~~~~~######.##~~~~~~~~~~~~~
~~~~~~~~~~~~###########...........#......#~~~~#........#######.......##~~~~~~~~~~~~~
~~~~~~~~~~~~##..........#.........#......#~~~~#........#.............##~~~~~~~~~~~~~
~~~~~~~~~~~~##......#...#.........#......#~~~~#...##...#...#.........##~~~~~~~~~~~~~
~~~~~~~~~~~~##..........#.....#...#......#~~~~#...##...#.......#.....##~~~~~~~~~~~~~
~~~~~~~~~~~~##..........#................#~~~~#........#...........####~~~~~~~~~~~~~
~~~~~~~~~~~~##.##########.###########.##########.#######.####.#########~~~~~~~~~~~~~
~~~~~~~~~~~~#..................................................###~~~##~~~~~~~~~~~~~
~~~~~~~~~~~~#####....................#.........................#~~~~~##~~~~~~~~~~~~~
~~~~~~~~~~~~##############################.....................########~~~~~~~~~~~~~
~~~~~~~~~~~~#####################~~~~~######.############............##~~~~~~~~~~~~~
~~~~~~~~~~~~#~~~~~~~~~~~~~~~~~~~~~~~~~#.........#~~#.......#.........##~~~~~~~~~~~~~
~~~~~~~~~~~~#################################################........##~~~~~~~~~~~~~
~~~~~~~~~~~~################..###~~~~~#########......##########......##~~~~~~~~~~~~~
~~~~~~~~~~~~###.....########..###~~~~~#..............#~~~~~~~~##.....##~~~~~~~~~~~~~
~~~~~~~~~~~~###...##########..####~~~######.#######.##############...##~~~~~~~~~~~~~
~~~~~~~~~~~~#.....###..#.........#~~~##......#.........#............###~~~~~~~~~~~~~
~~~~~~~~~~~~#########..#.........#~~~~#......#........#.....#.......##~~~~~~~~~~~~~~
~~~~~~~~~~~~~~~#.......#.........#~~~~#......#.......#......#.......##~~~~~~~~~~~~~~
~~~~~~~~~~~~#####......#.........######......#......#.......#.......##~~~~~~~~~~~~~~
~~~~~~~~~~~~~~~~####.######.######.####.#######.#######.######.#######~~~~~~~~~~~~~~
~~~~~~~~~~~~#####@..................................................##~~~~~~~~~~~~~~
~~~~~~~~~~~~#####.####################################################~~~~~~~~~~~~~~
~~~~~~~~~~~~#####.#~~~~~~~~~~~~~~~~~~~~~~~~~~~~~~~~~~~~~~~~~~~~~~~~~##~~~~~~~~~~~~~~
~~~~~~~~~~~~#####.###~~~~~~~~~~~~~~~~~~~~~~~~~~~~~~~~~~~~~~~~~~~~~~~##~~~~~~~~~~~~~~
~~~~~~~~~~~~#####.###~~~~~~~~~~~~~~~~~~~~~~~~~~~~~~~~~~~~~~~~~~~~~~~##~~~~~~~~~~~~~~
~~~~~~~~~~~~#####2###~~~~~~~~~~~~~~~~~~~~~~~~~~~~~~~~~~~~~~~~~~~~~~~##~~~~~~~~~~~~~~
~~~~~~~~~~~~~~~##.####################################################~~~~~~~~~~~~~~
~~~~~~~~~~~~#####....$#~~~~~~~~~~~~~~~~~~~~~~~~~~~~~~~~~~~~~~~~~~~~~~~~~~~~~~~~~~~~~
~~~~~~~~~~~~############################################################~~~~~~~~~~~~
~~~~~~~~~~~~~~~~~~~~~~~~~~~~~~~~~~~~~~~~~~~~~~~~~~~~~~~~~~~~~~~~~~~~~~~~~~~~~~~~~~~~
~~~~~~~~~~~~~~~~~~~~~~~~~~~~~~~~~~~~~~~~~~~~~~~~~~~~~~~~~~~~~~~~~~~~~~~~~~~~~~~~~~~~
~~~~~~~~~~~~~~~~~~~~~~~~~~~~~~~~~~~~~~~~~~~~~~~~~~~~~~~~~~~~~~~~~~~~~~~~~~~~~~~~~~~~
~~~~~~~~~~~~~~~~~~~~~~~~~~~~~~~~~~~~~~~~~~~~~~~~~~~~~~~~~~~~~~~~~~~~~~~~~~~~~~~~~~~~
~~~~~~~~~~~~~~~~~~~~~~~~~~~~~~~~~~~~~~~~~~~~~~~~~~~~~~~~~~~~~~~~~~~~~~~~~~~~~~~~~~~~
~~~~~~~~~~~~~~~~~~~~~~~~~~~~~~~~~~~~~~~~~~~~~~~~~~~~~~~~~~~~~~~~~~~~~~~~~~~~~~~~~~~~
~~~~~~~~~~~~~~~~~~~~~~~~~~~~~~~~~~~~~~~~~~~~~~~~~~~~~~~~~~~~~~~~~~~~~~~~~~~~~~~~~~~~
~~~~~~~~~~~~~~~~~~~~~~~~~~~~~~~~~~~~~~~~~~~~~~~~~~~~~~~~~~~~~~~~~~~~~~~~~~~~~~~~~~~~
~~~~~~~~~~~~~~~~~~~~~~~~~~~~~~~~~~~~~~~~~~~~~~~~~~~~~~~~~~~~~~~~~~~~~~~~~~~~~~~~~~~~
~~~~~~~~~~~~~~~~~~~~~~~~~~~~~~~~~~~~~~~~~~~~~~~~~~~~~~~~~~~~~~~~~~~~~~~~~~~~~~~~~~~~
~~~~~~~~~~~~~~~~~~~~~~~~~~~~~~~~~~~~~~~~~~~~~~~~~~~~~~~~~~~~~~~~~~~~~~~~~~~~~~~~~~~~
~~~~~~~~~~~~~~~~~~~~~~~~~~~~~~~~~~~~~~~~~~~~~~~~~~~~~~~~~~~~~~~~~~~~~~~~~~~~~~~~~~~~
~~~~~~~~~~~~~~~~~~~~~~~~~~~~~~~~~~~~~~~~~~~~~~~~~~~~~~~~~~~~~~~~~~~~~~~~~~~~~~~~~~~~
~~~~~~~~~~~~~~~~~~~~~~~~~~~~~~~~~~~~~~~~~~~~~~~~~~~~~~~~~~~~~~~~~~~~~~~~~~~~~~~~~~~~
~~~~~~~~~~~~~~~~~~~~~~~~~~~~~~~~~~~~~~~~~~~~~~~~~~~~~~~~~~~~~~~~~~~~~~~~~~~~~~~~~~~~
~~~~~~~~~~~~~~~~~~~~~~~~~~~~~~~~~~~~~~~~~~~~~~~~~~~~~~~~~~~~~~~~~~~~~~~~~~~~~~~~~~~~
~~~~~~~~~~~~~~~~~~~~~~~~~~~~~~~~~~~~~~~~~~~~~~~~~~~~~~~~~~~~~~~~~~~~~~~~~~~~~~~~~~~~
